[
  {
    "type" : "mapgen",
    "om_terrain" : ["morlock_village_sewer"],
    "method": "json",
    "weight": 1000,
    "object": {
      "fill_ter": "t_rock",
      "rows": [
        "         o####o         ",
        "         op##po         ",
        "         o####o         ",
        " ooooooooo####ooooooo   ",
        " o   ~~~~~~~~~p~~p--o   ",
        " o  ~~~~~~~~~~~~~~~-o   ",
        " o  ~~~||o~||~~||~~-o   ",
        " o  ~~-||ooP|oo||~~-o   ",
        " o  p~----oooo--+~~-o   ",
        "ooooo~~~~------~+~~-o   ",
        "o   ~~~~~~||D|~~+~~-o   ",
        "o   ~~~||~|>>|~||~~-oooo",
        "ooooo~~||~|>>|~||~~-----",
        "~~~~~~~~~~|D||~+~~~-----",
        "----~~~~~-----~+~~~-oooo",
        "   -~~----oooo-+~~~-o   ",
        "   ----||-oP|oo||~~-o   ",
        "   -~~~||-o||~o||o~-o   ",
        "   -~~~~~-~~~~oooo~-o   ",
        "   --~~~~-~~~~~~~~--o   ",
        "    ------####ooooooo   ",
        "          ~~~#o  o      ",
        "           ~~#o  o      ",
        "          ~~~#o  o      "
      ],
      "rotation": 0,
      "palettes": [ "sewers" ],
      "terrain":{"P": "t_concrete_wall", ">": "t_stairs_down"},
      "signs":{ "P": {"signage": "Secret Morlock Village" } }
    }
  }
]
