[
    {
        "type" : "mapgen",
        "om_terrain" : ["MLI_glass_workshop"],
        "method": "json",
  		"comment": "10000000 The default is 1000",
        "weight": 500,
        "object": {
            "fill_ter": "t_floor",
            "rows": [
                "gsssssssssssss,____,____",
                "gsssssssssssss,____,____",
                "gsssssssssssss,____,____",
                "g|AAAADDAAAA|s,____,____",
                "gA####..####As,____,____",
                "gAr........rAs,____,____",
                "gAr.##..##.rAs,____,____",
                "gAr.##..##.rAsssssssssss",
                "gAr.##..##.r|C----D---C|",
                "gAr.##..##.r|tRRRRxRRRt|",
                "gAr.........DxxxxxxxxxxC",
                "g|---.###.---qxxxxxxxxR|",
                "g|S.+..c..|.+xxxxqvqxxR|",
                "g|-+|-+----.|7xxxxxxxxR|",
                "g|Pj|r......|7xxxxxxxxtC",
                "g|--|---+----|RRRRRRRRR|",
                "gC8j|P|.....&|---------|",
                "g|8j|j|.ccc..+....+..::|",
                "g|-+-+|.TTT..|+---|....W",
                "g|w...+......|..7:|7...W",
                "g|y.r5|fK5OK.|....|....|",
                "g|-C----WW--D|c..@|c.@@|",
                "ggggg_dd_gggs|E&.@|E&@@|",
                "ggggg____gggs|-WW-|-WW-|"
            ],
            "terrain": {
                "s": "t_sidewalk",
                "g": "t_grass",
                "|": "t_wall",
                "-": "t_wall",
                "W": "t_window_domestic",
                "+": "t_door_c",
                "D": "t_door_locked",
                "_": "t_pavement",
                ",": "t_pavement_y",
                "d": "t_pavement",
                "A": "t_wall_glass",
                "C": "t_curtains",
                "j": "t_linoleum_white",
                "G": "t_linoleum_gray",
                "P": "t_linoleum_white",
                "a": "t_linoleum_white",
                "8": "t_linoleum_white",
                "e": "t_fencegate_c"
           },
            "furniture": {
                "E": "f_desk",
                "w": "f_washer",
                "y": "f_dryer",
                "7": "f_bookcase",
                "8": "f_bathtub",
                ":": "f_dresser",
                "F": "f_sofa",
                "B": "f_bench",
                "@": "f_bed",
                "T": "f_table",
                "#": "f_counter",
                "K": "f_cupboard",
                "f": "f_fridge",
                "S": "f_sink",
                "5": "f_sink",
                "d": "f_dumpster",
                "{": "f_rack",
                "O": "f_oven",
                "R": "f_rack",
                "v": "f_woodstove",
                "&": "f_trashcan",
                "L": "f_locker",
                "c": "f_chair",
                "q": "f_chair",
                "r": "f_rack",
                "t": "f_trashcan",
                "a": "f_counter",
                "^": "f_indoor_plant"
           },
            "toilets": {
                "P": { }
            },
            "place_items": [
            
                {"item": "glass_workshop_shop_window", "chance": 75, "x": [2,5],   "y": [4,4], "repeat": [1,0]},
                {"item": "glass_workshop_shop_window", "chance": 75, "x": [8,11],   "y": [4,4], "repeat": [1,0]},
                {"item": "glass_workshop_shop_window", "chance": 80, "x": [6,8],   "y": [11,11], "repeat": [1,0]},
                {"item": "glass_workshop_showcase", "chance": 75, "x": [2,2],   "y": [5,10], "repeat": [1,0]},
                {"item": "glass_workshop_showcase", "chance": 75, "x": [4,5],   "y": [6,9], "repeat": [1,0]},
                {"item": "glass_workshop_showcase", "chance": 75, "x": [8,9],   "y": [6,9], "repeat": [1,0]},
                {"item": "glass_workshop_showcase", "chance": 75, "x": [11,11],   "y": [5,9], "repeat": [1,0]},

                {"item": "glass_workshop_showcase", "chance": 25, "x": [14,17],   "y": [9,9], "repeat": [1,0]},
                {"item": "glass_workshop_showcase", "chance": 25, "x": [19,21],   "y": [9,9], "repeat": [1,0]},
                {"item": "glass_workshop_showcase", "chance": 25, "x": [22,22],   "y": [11,13], "repeat": [1,0]},
                {"item": "glass_workshop_showcase", "chance": 25, "x": [14,22],   "y": [15,15], "repeat": [1,0]},

                {"item": "glass_workshop_tools", "chance": 25, "x": [14,17],   "y": [9,9], "repeat": [1,0]},
                {"item": "glass_workshop_tools", "chance": 25, "x": [19,21],   "y": [9,9], "repeat": [1,0]},
                {"item": "glass_workshop_tools", "chance": 25, "x": [22,22],   "y": [11,13], "repeat": [1,0]},
                {"item": "glass_workshop_tools", "chance": 25, "x": [14,22],   "y": [15,15], "repeat": [1,0]},
                {"item": "glass_workshop_tools", "chance": 50, "x": [14,22],   "y": [10,14], "repeat": [1,0]},

                {"item": "glass_workshop_book_1", "chance": 70, "x": [13,13],   "y": [13,13], "repeat": [1,0]},
                {"item": "glass_workshop_book_2", "chance": 75, "x": [13,13],   "y": [14,14], "repeat": [1,0]},
                { "item": "glass_workshop_book_1", "chance": 30, "x": [ 16,16], "y": [ 19,19 ] },
                { "item": "glass_workshop_book_2", "chance": 50, "x": [ 16,16], "y": [ 19,19 ] },
                { "item": "glass_workshop_book_1", "chance": 30, "x": [ 19,19], "y": [ 19,19 ] },
                { "item": "glass_workshop_book_2", "chance": 50, "x": [ 19,19], "y": [ 19,19 ] },
                
                {"item": "MLI_toilets_sink",  "chance": 65, "x": 2, "y": 12 , "repeat": [1,0] },              
                {"item": "MLI_clean_locker",   "chance": 75, "x": 5, "y": 14, "repeat": [1,2]},
                
                {"item": "glass_workshop_trash",          "chance": 20, "x": [14,22],   "y": [10,14], "repeat": [1,0]},
                {"item": "glass_workshop_trash",          "chance": 50, "x": [22,22],   "y": [9,9], "repeat": [1,2]},
                {"item": "glass_workshop_trash",          "chance": 50, "x": [22,22],   "y": [14,14], "repeat": [1,2]},
                {"item": "glass_workshop_trash",          "chance": 80, "x": [6,7],   "y": [22,22], "repeat": [2,3]},
                
                { "item": "bed", "chance": 80,  "x": [17,17 ], "y": [21,22 ] },
                { "item": "bed", "chance": 80,  "x": [21,22 ], "y": [21,22 ] },
                { "item": "livingroom", "chance": 70,  "x": [ 7,11 ], "y": [ 16,19 ] },
                { "item": "dining", "chance": 70,  "x": [ 8,10 ], "y": [ 18,18 ] },
                { "item": "cannedfood", "chance": 30, "x": [ 8,8 ], "y": [ 20,20 ] },
                { "item": "bedroom", "chance": 60,  "x": [ 14,17 ], "y": [ 20,20 ] },
                { "item": "bedroom", "chance": 60,  "x": [ 20,22 ], "y": [ 18,20 ] },
                { "item": "dresser", "chance": 50,  "x": [ 21,22 ], "y": [ 17,17 ] },
                { "item": "dresser", "chance": 50,  "x": [ 17,17 ], "y": [ 19,19 ] },
                { "item": "consumer_electronics", "chance": 20,  "x": [ 19,19 ], "y": [ 22,22 ] },
                { "item": "homeguns", "chance": 20,  "x": [ 19,19 ], "y": [ 22,22 ] },
                { "item": "novels", "chance": 30, "x": [ 16,16], "y": [ 19,19 ] },
                { "item": "novels", "chance": 30, "x": [ 19,19], "y": [ 19,19 ] },
                { "item": "softdrugs", "chance": 50, "x": [ 5,5 ], "y": [ 20,20 ] },
                { "item": "kitchen", "chance": 70, "x": [ 8,11 ], "y": [ 20,20 ] },
                { "item": "fridge", "chance": 70, "x": [ 7,7 ], "y": [ 20,20 ] },
                { "item": "oven", "chance": 70, "x": [ 10,10 ], "y": [ 20,20 ] },
                { "item": "cannedfood", "chance": 20, "x": [ 4,4 ], "y": [ 20,20] },
                { "item": "pasta", "chance": 50, "x": [ 8,8 ], "y": [ 20,20 ] },
                { "item": "knifeblock", "chance": 30, "x": [ 8,8 ], "y": [ 20,20 ] },
                { "item": "dresser", "chance": 50, "x": [ 20,21 ], "y": [ 21,21 ] },
                { "item": "cleaning", "chance": 50, "x": [ 2,2 ], "y": [ 19,20 ] },
                {"item": "trash",          "chance": 50, "x": [12,12],   "y": [16,16], "repeat": [1,2]},
                {"item": "trash",          "chance": 50, "x": [15,15],   "y": [22,22], "repeat": [1,2]},
                {"item": "trash",          "chance": 50, "x": [20,20],   "y": [22,22], "repeat": [1,2]},

                {"item": "trash",          "chance": 10, "x": [0,13],   "y": [0,2], "repeat": [1,0]},
                {"item": "trash",          "chance": 50, "x": [14,23],   "y": [0,6], "repeat": [1,2]},
                {"item": "trash",          "chance": 50, "x": [0,5],   "y": [22,23], "repeat": [1,0]}
            ],
            "place_monsters": [
                {"monster": "GROUP_ZOMBIE","chance": 5, "x": [2,22],  "y": [9,20], "repeat": [1,2]}
            ] 
        }
    }
]
