[
    {
        "type" : "mapgen",
        "om_terrain" : ["MLI_s_pasta_restaurant"],
        "method": "json",
  		"comment": "10000000　デフォルトは1000",
        "weight": 500,
        "object": {
            "fill_ter": "t_floor",
            "rows": [
                "|-CWWC--|s____,____,____",
                "WFFF^FFFWs____,____,____",
                "W.......Ws____,____,____",
                "|{{&{{..|s____,____,____",
                "|---.#..Ds____,____,____",
                "|Sw|.@..|CWWC-CWWC-CWWC-",
                "|Sw|e|..|cTTc^cTTc^cTTc|",
                "|Swrw|..|cTTc.cTTc.cTTcC",
                "|awww+..+..............W",
                "|awww+..+..............W",
                "|Owwr|..|cTTc.cTTc.cTTcC",
                "|Owwf|..|cTTc^cTTc^cTTc|",
                "|Owwf|..|--------------|",
                "|Owwf|..|cTTc^cTTc^cTTc|",
                "|awwf|..|cTTc.cTTc.cTTcC",
                "Ctwww+..+..............W",
                "|wwww+..+..............W",
                "|+|---+-|----|cTTc.cTTcC",
                "|.|&...S|LLLL|cTTc^cTTc|",
                "|.|-+|+-|....|---------|",
                "|.|Pw|wP|.BBB|L{{&.B|dd|",
                "|.|-----|+---|.....B|++|",
                "|...................D___",
                "---------------------___"
            ],
            "terrain": {
                "|": "t_wall",
                "-": "t_wall",
                "W": "t_window_domestic",
                "+": "t_door_c",
                "D": "t_door_locked",
                "_": "t_pavement",
                ",": "t_pavement_y",
                "G": "t_wall_glass",
                "C": "t_curtains",
                "w": "t_linoleum_white",
                "g": "t_linoleum_gray",
                "d": "t_pavement",
                "S": "t_linoleum_white",
                "P": "t_linoleum_white",
                "R": "t_linoleum_white",
                "O": "t_linoleum_white",
                "r": "t_linoleum_white",
                "t": "t_linoleum_white",
                "a": "t_linoleum_white",
                "e": "t_fencegate_c",
                "s": "t_sidewalk",
                "@": "t_console_broken"
           },
            "furniture": {
                "F": "f_sofa",
                "B": "f_bench",
                "T": "f_table",
                "#": "f_counter",
                "f": "f_fridge",
                "S": "f_sink",
                "d": "f_dumpster",
                "{": "f_rack",
                "O": "f_oven",
                "R": "f_woodstove",
                "&": "f_trashcan",
                "L": "f_locker",
                "c": "f_chair",
                "r": "f_rack",
                "t": "f_trashcan",
                "a": "f_counter",
                "^": "f_indoor_plant"
           },
            "toilets": {
                "P": { }
            },
            "place_items": [
            
                {"item": "pasuta_restaur_table",  "chance": 25, "x": [10,11],   "y": [6,7], "repeat": [1,2]},
                {"item": "pasuta_restaur_table",  "chance": 25, "x": [15,16],   "y": [6,7], "repeat": [1,2]},
                {"item": "pasuta_restaur_table",  "chance": 25, "x": [20,21], "y": [6,7], "repeat": [1,2]},
                
                {"item": "pasuta_restaur_table",  "chance": 25, "x": [10,11],   "y": [10,11], "repeat": [1,2]},
                {"item": "pasuta_restaur_table",  "chance": 40, "x": [10,11],   "y": [13,14], "repeat": [1,2]},
                
                {"item": "pasuta_restaur_table",  "chance": 25, "x": [15,16],   "y": [10,11], "repeat": [1,2]},
                {"item": "pasuta_restaur_table",  "chance": 35, "x": [15,16],   "y": [13,14], "repeat": [1,2]},
                {"item": "pasuta_restaur_table",  "chance": 40, "x": [15,16],   "y": [17,18], "repeat": [1,2]},
                
                {"item": "pasuta_restaur_table",  "chance": 25, "x": [20,21], "y": [10,11], "repeat": [1,2]},
                {"item": "pasuta_restaur_table",  "chance": 25, "x": [20,21], "y": [13,14], "repeat": [1,2]},
                {"item": "pasuta_restaur_table",  "chance": 25, "x": [20,21], "y": [17,18], "repeat": [1,2]},

                {"item": "pasuta_restaur_cash_register",  "chance": 50, "x": 5, "y": 4 , "repeat": [1,2]},
                
                {"item": "pasuta_restaur_bath",  "chance": 25, "x": [3,7], "y": 20 , "repeat": [1,2] },
                {"item": "MLI_toilets_sink",  "chance": 65, "x": 7, "y": 18 , "repeat": [1,0] },
                
                {"item": "pasuta_restaur_fridge", "chance": 70, "x": 4,   "y": [11,12], "repeat": [2,3]},
                {"item": "pasuta_restaur_fridge", "chance": 70, "x": 4,   "y": [13,14], "repeat": [2,3]},
                
                {"item": "pasuta_restaur_oven","chance": 75, "x": 1, "y": [10,13], "repeat": [1,2]},
                
                {"item": "pasuta_restaur_sink",   "chance": 75, "x": 1, "y": [5,7], "repeat": [2,3]},
                
                {"item": "pasuta_restaur_kitchen","chance": 25, "x": 1,       "y": [8,9], "repeat": [1,2]},
                {"item": "pasuta_restaur_kitchen","chance": 25, "x": 1,       "y": 14, "repeat": [1,2]},
                
                {"item": "pasuta_restaur_rack",   "chance": 75, "x": 3, "y": 7, "repeat": [2,3]},
                {"item": "pasuta_restaur_rack",   "chance": 75, "x": 4, "y": 10, "repeat": [2,3]},
                
                {"item": "pasuta_restaur_trash",  "chance": 75, "x": 3,   "y": 3, "repeat": [1,2]},
                {"item": "pasuta_restaur_trash",  "chance": 75, "x": 1,   "y": 15, "repeat": [1,2]},
                {"item": "pasuta_restaur_trash",  "chance": 75, "x": 3,   "y": 18, "repeat": [1,2]},
                {"item": "pasuta_restaur_trash",  "chance": 75, "x": 17,   "y": 20, "repeat": [1,2]},
               
                {"item": "pasuta_restaur_locker","chance": 75, "x": [9,10],  "y": 18, "repeat": [1,2]},
                {"item": "pasuta_restaur_locker","chance": 75, "x": [11,12], "y": 18, "repeat": [1,2]},
                
                {"item": "MLI_clean_locker",   "chance": 75, "x": 14, "y": 20, "repeat": [1,2]},
                {"item": "pasuta_restaur_backyard_rack",   "chance": 75, "x": [15,16], "y": 20, "repeat": [1,3]},
                
                {"item": "pasuta_restaur_book_rack",   "chance": 75, "x": [1,2], "y": 3, "repeat": [1,2]},
                
                {"item": "pasuta_restaur_buy_rack",   "chance": 35, "x": [4,5], "y": 3, "repeat": [1,2]},
                
                {"item": "pasuta_restaur_trash",  "chance": 50, "x": [21,22],   "y": 20, "repeat": [2,3]},
                {"item": "trash",          "chance": 50, "x": [9,23],   "y": [0,4], "repeat": [1,2]}
            ],
            "place_monsters": [
                {"monster": "GROUP_GROCERY_PASTA","chance": 5, "x": [3,7],  "y": [18,20]},
                
                {"monster": "GROUP_GROCERY","chance": 30, "x": [1,7],  "y": [1,3]},
                {"monster": "GROUP_GROCERY","chance": 20, "x": [9,22],  "y": [6,16]},
                {"monster": "GROUP_GROCERY","chance": 5, "x": [2,4],  "y": [5,16]},
                {"monster": "GROUP_GROCERY","chance": 10, "x": [9,19],  "y": [19,22]}
            ] 
        }
    }
]
