[ 
  {
    "type": "mapgen",
    "method": "json",
    "om_terrain": [ "omni_outpost_entrance" ],
    "object": {
      "rows": [
        "                        ",
        " -----------------------",
        " |                     |",
        " |                     |",
        " |                     |",
        " |                     |",
        " |                     |",
        " |     MMMMMMMMMM      |",
        " |     MMMMMMMMMM      |",
        " |     MMMM>>MMMM      |",
        " |     MM,,,,,,MM      |",
        " |     MMMM,,MMMM      |",
        " |     MM,,,,,,MM      |",
        " |     MMMM,,MMMM      |",
        " |     MM,,,,,,MM      |",
        " |     MMMM,,MMMM      |",
        " |     MMMM  MMMM      |",
        " +                     +",
        " +                     +",
        " +                     +",
        " +                     +",
        " +                     +",
        " +-------++++++--------+",
        "                        "
      ],
      "terrain": {
        " ": [ "t_grass", "t_grass", "t_grass", "t_dirt" ],
        "*": "t_door_c",
        "+": "t_chaingate_l",
        "-": "t_chainfence_h",
        ">": "t_stairs_down",
        "I": "t_ballistic_glass",
        "M": "t_wall_metal",
        "|": "t_chainfence_v",
		",": "t_thconc_floor"
      }
    }
  },
  {
    "type": "mapgen",
	"method": "json",
	"om_terrain": [ "omni_outpost_under" ],
	"object": {
	  "fill_ter": "t_metal_floor",
	  "rows": [
	    "#########################",
		"#MMMMMMMMMMMMMMMMMMMMMMM#",
		"#M,,,,,,,,,M,,M,,,,,,,,M#",
		"#M,,,,,,,,,D,,D,,,,,,,,M#",
		"#M,,,,,,,,,M,,M,,,,,,,,M#",
		"#M,,,,,,,,,M,,M,,,,,,,,M#",
		"#M,,,,,,,,,M,,M,,,,,,,,M#",
		"#MMMMMMMMMMM,,MMMMMMMMMM#",
		"#M,,,,,,,,,,,,,,,,,,,,,M#",
		"#M,,,,,,,,,,,,,,,,,,,,,M#",
		"#M,,,,,,,,,,,,,,,,,,,,,M#",
		"#M,,,,,,,,,,,,,,,,,,,,,M#",
		"#M,,,,,MMMMMDMMMMM,,,,,M#",
		"#M,,,,,M,,,,,,,,,M,,,,,M#",
		"#M,,,,,M,,,,,,,,,M,,,,,M#",
		"#M,,,,,M,,,,,,,,,M,,,,,M#",
		"#M,,,,,M,,,,,,,,,M,,,,,M#",
		"#M,,,,,M,,,,<<,,,M,,,,,M#",
		"#M,,,,,MMMDMMMMMMM,,,,,M#",
		"#M,,,,,M,,,,,,,,,M,,,,,M#",
		"#M,,,,,M,,,,,,,,,M,,,,,M#",
		"#M,,,,,M,,,,,,,,,M,,,,,M#",
		"#MMMMMMMMMMMMMMMMMMMMMMM#",
		"#########################"
	],
	"terrain": {
	  "#": "t_rock",
	  "M": "t_wall_metal",
	  "D": "t_door_metal_c",
	  ",": "t_metal_floor",
      "<": "t_stairs_up"
	  }
	}
  },
  {
    "type": "mapgen",
    "method": "json",
    "om_terrain": [ "omni_outpost_roof" ],
    "object": {
      "rows": [
        "                        ",
        "                        ",
        "                        ",
        "                        ",
        "                        ",
        "                        ",
        "                        ",
        "       MMMMMMMMMM       ",
        "       MMMMMMMMMM       ",
        "       MMMMMMMMMM       ",
        "       MMMMMMMMMM       ",
        "       MMMMMMMMMM       ",
        "       MMMMMMMMMM       ",
        "       MMMMMMMMMM       ",
        "       MMMMMMMMMM       ",
        "       MMMMMMMMMM       ",
        "       MMMMMMMMMM       ",
        "                        ",
        "                        ",
        "                        ",
        "                        ",
        "                        ",
        "                        ",
        "                        "
      ],
      "terrain": {
	    " ": "t_open_air",
        "M": "t_flat_roof"
      }
    }
  }
]  