[
  {
    "method": "json",
    "om_terrain": "osrs_forge_lum",
    "//": "lumbridge variant",
    "type": "mapgen",
    "weight": 100,
    "object": {
      "fill_ter": "t_floor",
      "rows": [
        "                        ",
        "                        ",
        "                        ",
        "                        ",
        "                        ",
        "                        ",
        "                        ",
        "        xxx  xxx        ",
        "        xt....tx        ",
        "        xt....tx        ",
        "        xc....Rx        ",
        "         .....Rx        ",
        "         .....Rx        ",
        "        xB....bx        ",
        "        x...a.fx        ",
        "        xrr.xxxx        ",
        "        xxxxx           ",
        "                        ",
        "                        ",
        "                        ",
        "                        ",
		"                        ",
        "                        ",
        "                        "
      ],
      "terrain": {
	    " ": "t_grass",
		"x": "t_rock_wall",
		".": "t_metal_floor",
		"f": "t_metal_floor",
		"a": "t_metal_floor",
		"B": "t_metal_floor"
	  },
	  "furniture": {
		"f": "f_forge_rock",
		"a": "f_anvil",
		"b": "f_bellows",
		"t": "f_workbench",
		"c": "f_crate_o",
		"r": "f_counter",
		"R": "f_rack",
		"B": "f_bookcase"
      },
	  "place_loot": [
	    { "group": "osrs_materials", "x": 9, "y": 10, "chance": 100, "repeat": 5 },
		{ "group": "osrs_tools", "x": 14, "y": [ 10, 11 ], "chance": 100, "repeat": 2 },
		{ "group": "osrs_misc_money", "x": 14, "y": 12, "chance": 100, "repeat": 5 },
		{ "group": "osrs_books", "x": 9, "y": 13, "chance": 100, "repeat": 2 }
	  ]	
    }
  },
  {
    "method": "json",
    "om_terrain": "osrs_forge_lum_roof",
    "//": "lumbridge variant",
    "type": "mapgen",
    "weight": 100,
    "object": {
      "fill_ter": "t_open_air",
      "rows": [
        "                        ",
        "                        ",
        "                        ",
        "                        ",
        "                        ",
        "                        ",
        "                        ",
        "        xxxxxxxx        ",
        "        xxxxxxxx        ",
        "        xxxxxxxx        ",
        "        xxxxxxxx        ",
        "        xxxxxxxx        ",
        "        xxxxxxxx        ",
        "        xxxxxxxx        ",
        "        xxxxxxxx        ",
        "        xxxxxxxx        ",
        "        xxxxx           ",
        "                        ",
        "                        ",
        "                        ",
        "                        ",
		"                        ",
        "                        ",
        "                        "
      ],
      "terrain": {
	    " ": "t_open_air",
		"x": "t_tile_flat_roof"
      }
    }
  },
  {
    "method": "json",
    "om_terrain": "osrs_forge_varrock",
    "//": "varrock variant",
    "type": "mapgen",
    "weight": 100,
    "object": {
      "fill_ter": "t_floor",
      "rows": [
        "                        ",
        "                        ",
        "                        ",
        "                        ",
        "                        ",
        "                        ",
        "                        ",
        "        xxxdxxxx        ",
        "        xB...RRx        ",
        "        x...a..x        ",
        "        x......x        ",
        "        d...a.cx        ",
        "        x.....cx        ",
        "        x.t....x        ",
        "        x.t.a..x        ",
        "        x.....hx        ",
        "        xxxxxxxx        ",
        "                        ",
        "                        ",
        "                        ",
        "                        ",
		"                        ",
        "                        ",
        "                        "
      ],
      "terrain": {
	    " ": "t_grass",
		"x": "t_rock_wall",
		".": "t_metal_floor",
		"d": "t_door_c",
		"a": "t_metal_floor",
		"h": "t_metal_floor",
		"B": "t_metal_floor",
		"R": "t_metal_floor"
	  },
	  "furniture": {
		"a": "f_anvil",
		"t": "f_workbench",
		"c": "f_crate_o",
		"h": "f_chair",
		"B": "f_bookcase",
		"R": "f_rack"
      },
	  "place_loot": [
	    { "group": "osrs_materials", "x": 14, "y": [ 11, 12 ], "chance": 100, "repeat": 5 },
		{ "group": "osrs_tools", "x": 13, "y": 8, "chance": 100, "repeat": 2 },
		{ "group": "osrs_misc_money", "x": 14, "y": 8, "chance": 100, "repeat": 5 },
		{ "group": "osrs_books", "x": 9, "y": 8, "chance": 100, "repeat": 2 }
	  ]
    }
  },
  {
    "method": "json",
    "om_terrain": "osrs_forge_varrock_roof",
    "//": "varrock variant",
    "type": "mapgen",
    "weight": 100,
    "object": {
      "fill_ter": "t_open_air",
      "rows": [
        "                        ",
        "                        ",
        "                        ",
        "                        ",
        "                        ",
        "                        ",
        "                        ",
        "        xxxxxxxx        ",
        "        xxxxxxxx        ",
        "        xxxxxxxx        ",
        "        xxxxxxxx        ",
        "        xxxxxxxx        ",
        "        xxxxxxxx        ",
        "        xxxxxxxx        ",
        "        xxxxxxxx        ",
        "        xxxxxxxx        ",
        "        xxxxxxxx        ",
        "                        ",
        "                        ",
        "                        ",
        "                        ",
		"                        ",
        "                        ",
        "                        "
      ],
      "terrain": {
	    " ": "t_open_air",
		"x": "t_tile_flat_roof"
	  }
	}
  }
]