[
  {
    "method": "json",
    "om_terrain": "mil_surplus_2",
    "type": "mapgen",
    "weight": 100,
    "object": {
      "fill_ter": "t_floor",
      "rows": [
        "___d___ud___________ss__",
        "__||||||||||||------ssr_",
        "_u|####.....Dsssssssssr_",
        "_S|.........Dsssssssssr_",
        "_u|.{{{.....|||||||||||_",
        "d_|........^|....{{{{{|_",
        "__|####.....+..c.....{|_",
        "__|||||.....||######|||d",
        "__|###................|_",
        "__|{.....tt...........|_",
        "_S|{.....tt...........|u",
        "_u|###........{{.{{..{|u",
        "_d|||||.......{{.{{..{|_",
        "__|###...tt...{{.{{..{|_",
        "__|#.....tt...{{.{{..{|_",
        "__|#..........{{.{{..{|_",
        "__|#..........{{.{{..{|d",
        "_u|b...||||||.{{.{{..{|u",
        "__|b...|llll|.{{.{{..{|_",
        "__||||.|....|........{|_",
        "__|&.+.+....|||||||||||4",
        "d_|%.|y|tc..+ss____duS__",
        "__|||||||||||ss_________",
        "____u_u_______________d_"
      ],
      "terrain": {
        "+": "t_door_c",
        "-": "t_railing_h",
        ".": "t_floor",
        "D": "t_door_glass_c",
        "S": "t_shrub",
        "_": "t_grass",
        "d": "t_dirt",
        "r": "t_railing_v",
        "s": "t_sidewalk",
        "u": "t_underbrush",
        "|": "t_wall_g",
        "4": "t_gutter_downspout"
      },
      "furniture": {
        "#": "f_counter",
        "^": "f_indoor_plant",
        "b": "f_bench",
        "c": "f_chair",
        "l": "f_locker",
        "t": "f_table",
        "{": "f_rack",
        "%": "f_sink",
        "y": [ "f_indoor_plant_y", "f_indoor_plant" ]
      },
      "toilets": { "&": {  } },
      "place_items": [
        { "chance": 75, "repeat": [ 1, 2 ], "item": "mil_armor_pants", "x": [ 3, 5 ], "y": 11 },
        { "chance": 75, "repeat": [ 1, 2 ], "item": "mil_armor_pants", "x": [ 3, 5 ], "y": 8 },
        { "chance": 75, "repeat": [ 1, 4 ], "item": "jackets", "x": [ 8, 9 ], "y": 18 },
        { "chance": 85, "repeat": [ 1, 3 ], "item": "winter", "x": [ 4, 5 ], "y": 13 },
        { "chance": 85, "repeat": [ 1, 3 ], "item": "winter", "x": [ 3, 6 ], "y": 6 },
        { "chance": 85, "repeat": [ 1, 3 ], "item": "winter", "x": [ 3, 6 ], "y": 2 },
        { "chance": 75, "repeat": [ 1, 4 ], "item": "mil_accessories", "x": 3, "y": [ 13, 16 ] },
        { "chance": 85, "repeat": [ 1, 3 ], "item": "magazines", "x": [ 10, 11 ], "y": 18 },
        { "chance": 95, "repeat": [ 1, 3 ], "item": "knife_shop", "x": [ 4, 6 ], "y": 4 },
		
		{ "chance": 35, "repeat": [ 1, 2 ], "item": "guns_shot_ww2", "x": 21, "y": 6 },
		{ "chance": 35, "repeat": [ 1, 2 ], "item": "guns_heavy_ww2", "x": 21, "y": 5 },
        { "chance": 35, "repeat": [ 1, 2 ], "item": "guns_rifle_ww2", "x": 20, "y": 5 },
		{ "chance": 35, "repeat": [ 1, 2 ], "item": "guns_pistol_ww2", "x": 19, "y": 5 },
        { "chance": 35, "repeat": [ 1, 2 ], "item": "guns_smg_ww2", "x": 18, "y": 5 },
		
		{ "chance": 35, "repeat": [ 1, 3 ], "item": "mags_heavy_ww2", "x": 21, "y": 5 },
		{ "chance": 35, "repeat": [ 1, 3 ], "item": "mags_rifle_ww2", "x": 20, "y": 5 },
		{ "chance": 35, "repeat": [ 1, 3 ], "item": "mags_pistol_ww2", "x": 19, "y": 5 },
        { "chance": 35, "repeat": [ 1, 3 ], "item": "mags_smg_ww2", "x": 18, "y": 5 },
		
		{ "chance": 35, "repeat": [ 1, 4 ], "item": "ammo_shot_ww2", "x": 21, "y": 6 },
		{ "chance": 35, "repeat": [ 1, 4 ], "item": "ammo_heavy_ww2", "x": 21, "y": 5 },
		{ "chance": 35, "repeat": [ 1, 4 ], "item": "ammo_rifle_ww2", "x": 20, "y": 5 },
		{ "chance": 35, "repeat": [ 1, 4 ], "item": "ammo_pistol_ww2", "x": 19, "y": 5 },
        { "chance": 35, "repeat": [ 1, 4 ], "item": "ammo_smg_ww2", "x": 18, "y": 5 },
		
		{ "chance": 35, "repeat": [ 1, 2 ], "item": "uniform_ww2", "x": 17, "y": 5 },
		
        { "chance": 35, "repeat": [ 1, 4 ], "item": "mil_surplus", "x": [ 9, 10 ], "y": [ 13, 14 ] },
        { "chance": 75, "repeat": [ 1, 4 ], "item": "mil_surplus", "x": 21, "y": [ 11, 19 ] },
        { "chance": 75, "repeat": [ 1, 4 ], "item": "mil_surplus", "x": [ 17, 18 ], "y": [ 11, 18 ] },
        { "chance": 75, "repeat": [ 1, 4 ], "item": "mil_surplus", "x": [ 14, 15 ], "y": [ 11, 18 ] },
        { "chance": 75, "repeat": [ 1, 4 ], "item": "mil_surplus", "x": [ 9, 10 ], "y": [ 9, 10 ] }
      ]
    }
  }
]