[
  {
    "type": "mapgen",
    "method": "json",
    "weight": 1300,
    "om_terrain": [ "GKB_CHINPOD_1" ],
    "object": {
      "fill_ter": "t_floor",
      "rows": [
        ",,,,,,,,,,,,,,,,,,,,,,,,",
        ",,,,,,,,,,,,,,,,,,,,,,,,",
        ",,,,d,,,,,,,,,,,,,,,,,,,",
        ",,,,dd,,,,,,dd,,,,d,,,,,",
        ",,,,,,,,,,,,,d,d,,,dd,,,",
        ",,,,,,,,,,,,,,,,d,,d,,,,",
        ",,,d,,,,,,,,,,,,,,,dd,,,",
        ",,,,,,,,,,,,,,,,,,,,dd,,",
        ",,,,,,,,,WWfWW,,,,,,,,,,",
        "d,,,,,,,WWfffWW,,,,,,,,,",
        ",dd,,,,,Wf1f2fW,,,d,,,,,",
        ",,,d,,,,fffffff,,,,,,,,,",
        ",,d,,,,,Wf2f3fW,,,,dd,,,",
        ",,,,,,,,WWfffWW,,,,,,,,,",
        ",,,,,,,d,WWfWW,,,d,,,,,,",
        ",,,,,,ddd,,,,,,,,,,,,,,,",
        ",,,,,,,,,,,,,,,,,,,,,,,,",
        ",,,,,,,,,,,,,,,,,,,,,,,,",
        ",,,,,,d,,,,,,,d,,,,,,,,,",
        ",,,,,,,,,,,,,,,d,,,,,,,,",
        ",,,,,,,,,,,,,,,d,,,,,,,,",
        ",,,,,dd,,,,,,d,d,,,,,,,,",
        ",,,,ddd,,,,,,,,,,,,,,,,,",
        ",,,,,,,,,,,,,,,,,,,,,,,,"
      ],
      "palettes": [ "GKB_CHINPAL" ],
      "place_monsters": [ { "monster": "GROUP_CHINESE_DRONES", "x": [ 2, 23 ], "y": [ 2, 23 ], "density": 1.2 } ],
      "terrain": { ",": "t_region_groundcover" }
    }
  },
  {
    "type": "mapgen",
    "method": "json",
    "om_terrain": "GKB_CHINPOD_1_roof",
    "weight": 100,
    "object": {
      "fill_ter": "t_open_air",
      "rows": [
        "                        ",
        "                        ",
        "                        ",
        "                        ",
        "                        ",
        "                        ",
        "                        ",
        "                        ",
        "         .....          ",
        "        .......         ",
        "        .......         ",
        "        .......         ",
        "        .......         ",
        "        .......         ",
        "         .....          ",
        "                        ",
        "                        ",
        "                        ",
        "                        ",
        "                        ",
        "                        ",
        "                        ",
        "                        ",
        "                        "
      ],
      "terrain": { ".": "t_metal_floor" }
    }
  }


]
